# Valens. -  baetsedh 

Gosse jielede nåhka dellie dïhte aaj akte siebriedahkedåeriesmoere , jïh akte stoerre vaejvie dejtie mah	baetsieh	saemien dajvine , saemiedigkiepresidente Aili Keskitalo jeahta .

Jis jijnje soptsestalleme vuepsij bijre sjædta , dellie learohkh maehtieh damtedh eah dah buektedh darjodh maam sijhtieh , jih nimhtie minngesne	baetsieh	.
Religion textsstøtter ikke utvidet kontekst

« Sjïehtesjim dejnie gïem veeljim , Davidasse , mov deanarasse , naemhtie våarnoejim : Dov boelvh ihkuve aajkan	baetsieh	; dov åajvemes tjahkes-sijjie iktesth tjåådtje .
Ij gie dov nommem tjåarvoeh , ij gie fahkah jïh ij gie dov gåajkoe	baetsieh.

Dellie Jeesuse jeahta : « Biejjieh golh båetieh gosse gaajhkem maam daesnie vuejnede , galka gajhkanidh guktie ij gierkie gierkien nille	baetsieh.

Læjhkan im oktegh	baetsieh	juktie Aehtjie mov luvnie.

Im veartanasse	baetsieh.

MænnganÅejvie Mosese jeehti : « Båetieh mov gåajkoe bæjjese vaaran jïh	baetsieh	daase , dellie edtjem tjaaleh-gierkide jïh laakem jïh båvrojde dutnjien vedtedh , mejtie manne tjaaleme almetjidie ööhpehtidh .

Orre saernieh desnie	baetsieh.

12 Jupmele Mosese jeahta : ” Båetieh mov gåajkoe bijjene vaeresne jïh	baetsieh	dïsse , dellie edtjem dejtie tjaelemegierkide jïh laakem jïh båvrode dutnjien vedtedh , maam almetjidie tjaaleme , dejtie ööhpehtidh .


Voenen bievle-geajnoeh vuelnie (våålese)	baetsieh	tjaahpesjen , girtie jis bijjiebasse guatsa guktie dogkh daagkh , balve-gaskem , maahta vaartoej rudtjh , vaeriej dalvesh vuejnedh , namhtah jadtnan goh daalvege .

Dannasinie staarh jïh stoerre tjåanghkenimmiesijjieh almetjijstie læssanieh jïh vaenebh almetjh bårroes dajvide	baetsieh.


Girtieh Arizonen gearkeskasse	baetsieh	, gosse eah maehtieh vielie dejgujmie girtedh .
Fiction textsstøtter ikke utvidet kontekst
haeliehtidh haelehte geehth	baetsieh	vaesieh
geehth olleh	baetsieh	!

Voenen bievlegeajnoeh vuelnie	baetsieh	tjaahpesjen , girtie jis bijjiebasse guatsa guktie dogkh daagkh , balvegaskem , maahta vaartoej rudtjh , vaeriej dalvesh vuejnedh , namhtah jadtnan goh daalvege .

Dah jis gieh daejtie noerhte laantide	baetsieh	, dejstie såamesh sijhtieh miehtjies dajvide ohtsedidh , vaerine vaadtsehtjidh jih aaj gøøledadtedh .


# laehpedh 