buajhkedh - illativ
bïlledh - elativ - staaloste bïlledh = er redd for troll
Bïlledh - komitativ - redd for noe ´steeblegigujmie balla= ´er redd for støvlene sine´
sjïdtedh - inessiv, essiv
mïnnedh - inessiv, illativ
jaehkedh - ackusativ, illativ - jupmielasse jaahkam = jeg tror på gud
           dam jaahkam = det tror jeg
raeriestidh - Illativ = 
rååresjidh - KOMITATIV
vissjehtovvedh - elativ? destie vïssjehtåvva= blir lei av det
gaskesadtedh - kom?
govlesadtedh - kom
govlehtalledh - kom?
vuartasjidh - ack, ill
goltelidh - ack, ill= tjidtjiem goltelidh= høre på mor.
baajpalidh - ela
tjöödtjestidh - ill, kanskje også innesiv? en norvagisme muligens - daase tjöödtjestidh. 

baetsedh - ill, også innesiv? kanskje en norvagisme = daesnie baetsedh= bli igjen her. daase baetsedh? 
tjaangedh - ill - gåatan tjaangedh
tjihkedidh - ill - daase tjihkedidh
nihtedh - ela, Ack "Bïenjem nihtedh", destie nihtedh= fraråde fra det.
tjihkedidh - ill
göörjedh -illativ, adverbial 'dohkoe'
veeledh - illativ
tjaakanidh - illativ
måarahtovvedh - illativ (mejtie måarahtåvva)
steeredh - ack, og ellativ= dam steerem= jeg holder det(objektet) mens ´gïeteste steeredh´(jeg holder (deg) i handa).
gåårvedidh - akkusativ, illativ= "Dihte saemie veelti jih noeledi Staaloen gaarvoeh jih jïjtsasse gåarvedi".

guarjasjidh-innesiv
vealasjidh-innesiv
tjahkasjidh-innesiv

Følelsesverbene '+': 
mårrahtovvedh - illativ - tjædtjan mårrahtovvedh = å bli sint på mor
gearodh -illativ = dutnjien gearoejim= ble forelsket i deg
gaerteles - gaartalovvedh - Illativ - dutnjien gaartalovveme= bli deg tro, har roet seg ned med deg. 

Ussjedidh - Illativ = "Ih daarpesjh dïsse ussjedidh" = Du behøver ikke tenke på det

