§ 96.2. –ehtjidh, -ehtjadtedh(frek.kon)
vaadtsehtjidh – vaadtsedh(vaedtsedh)

juhtedh - johtehtjidh, johtetjadtedh=(e-Omlyd)
vaedtsedh = vaadtsehtjidh =(a-Omlyd)=(I)
åestedh = åastehtjidh a-omljud
gaeledh = gaalehtjidh (vada) driva på och vada (a-omljud)
bielhkedh I = bïelkehtjidh (bïelhkedh) stadigt hålla på skälla, skälla på den ena efter den andra (e-omljud
biekedh = bïekehtjidh (vada (i snö)) hålla på vada (e-omljud)
bihkedh = bïhkehtjidh (plocka) småplocka (e-omljud)
gervedh = garvehtjidh - ta omveier, om f.eks flere tjern)
        = gïesehtjidh/geasehtjidh
        = dovvehtjidh
gaeledh   = gaalehtjidh (drive på å vade) 
gaetskedh = gaatskehtjidh (drive å småbite) 
gedtedh = gadtehtjidh (stadig drepe)
gieltedh= gïeltehtjidh (stadig spenne flere)
goeredh = goerehtjidh(stadig undersøke)
          goerehtjidh(= dra av sted med det ene og det andre)

guedtedh(1) = goedtehtjidh (stadig holde på å kalve, så smått begynne å kalve) 
u,ae,åe =omlyd + -tjidh

bohtjehtjadted - buhtjedh   TJOEHPEDH "hålla på och mjölka"    ; (e-omljud)
gadtehtjadtedh - gedtedh    TJOEHPEDH "hålla på och döda"    ; (a-omljud)
hohtehtjadtedh - huhtedh      TJOEHPEDH "småskälla hela tiden"    ; (e-omljud)


bartehtjidh - bertedh I          GOLTELIDH  "stapla upp" ;
boelehtjidh - bueledh I      GOLTELIDH  "bränna sig" ;
bovvehtjidh - buvvedh I         GOLTELIDH  "döda, mörda (flera människor, djur)" ;
gadtehtjidh - gedtedh          GOLTELIDH  "ständigt döda";
raarhkehtjidh - raerhkedh    GOLTELIDH   "bedriva skiljning" ;
sovvehtjidh - suvvedh          GOLTELIDH  "växa igen (om stig) (sydl.)";
vaadtsehtjidh - vaedtsedh      GOLTELIDH "gå omkring" ;
voetjehtjidh - vuetjedh        GOLTELIDH "ständigt skjuta" ;
åarehtjidh - åeredh            GOLTELIDH "ligga med kvinna" ; (a-omljud)
åastehtjidh - åestedh         GOLTELIDH "småhandla" ; (a-omljud)

voessjehtjidh - voessjedh (inget omljud)
