dulmedibe	dulmedibie	# Deverbal verb
nïejtetjesse	nïejtetjasse	# Denominal noun
vuasatalleles	vuasahtalleles	# Deverbal adj
AP-beetnegeh	AP-beetnegh	# Acro + noun compound
AOF-åabpeje	AOF-åabpije	# Acro + Derivated noun compound
mistije-NRK:esne	mistije-NRK:sne	# Derivated noun + acro compound
st.diedråanjoemijstie	St.died-råanjoemijstie	# Abbr + derivated noun compound
St.died-samkahierkie	St.died-samkashierkie	# Abbr + adj + noun compound
10-galvåajja	10-gaalvåajja	# Digit + noun compound
barketalledh	barkehtalledh	# Deverbal verb
tjoepehtalligangan	tjoehpehtalligangan	# Deverbal verb + clitc
treempesovvimh	treemhpesovvimh	# Deverbal verb
gervelibie	gervielibie	# Deverbal verb
tsoetsesjidiege	tsoedtsesjidie	# Deverbal verb + clitic
doelmestid	doelmestidh	# Deverbal verb
jaevrijes	jaavrijes	# Denominal adj
laahpalassesne	laahpelassesne	# Deverbal adj
byssegåetijægan	byssegåetiejægan	# Deverbal verb
gierehtsadtjese	gieriehtsadtjese	# Deverbal noun
bïssemenniejtetjijstie	bïssemenïejtetjijstie	# Deverbal noun + deverbal noun compound
gieltijesakesanne	gieltijesaakesanne	# Deverbal noun + noun compound
vaeredimmiesaakenjaevriem	vaeriedimmiesaakenjaevriem	# Deverbal noun + noun + noun compound
ruevtienbiestemimoerijvaarjoen	ruevtienbiestemimoerivaarjoen	# Noun + deverbal noun + noun + noun compound
ovmessietjoelijiprihtjegigujmie	ovmessietjoelijiprïhtjegigujmie	# Adj + denominal noun + noun
Bas-stredet	Bass-stredet	# Name
Fisklös-gieregisjsie	Fisklös-gïeregijstie	# Name
Fort-de-France-geirhkie	Fort-de-France-gierhkie	# Name + noun compound
Koskimies-soejkesjimmereagkaj	Koskimies-soejkesjimmiereagkaj	# Name + noun + noun compound
aeblehtsvoetegærjaamhtesh	aeblehtsvoetegærjaaamhtesh	# Noun + noun + noun compound
ledtiejmoerisoejjegimmiengeannah	ledtiejmoerisoejjegimmiengænnah	# Noun + noun + deverbal noun + clitic
sijjiesaernienniejtinegan	sijjiesaernienïejtinegan	# Noun + noun +noun + clitic
gealtelesvoetegeh	gealtelesvoetegih	# Deadjectival noun + clitic
aeblehtsvoetenath	aeblehtsvoetenadth	# Noun
Tjellientjånnide	Tjellientjåånnide	# Name
Tjellientjåånne-Tjiddiemaajjinie	Tjellientjåånne-Tjiddiemaajjine	# Name gen + name compound
balvedhlaketje	balvedhlaaketje	# Adj
jælam	jealam	# Verb
bienjengåaksahvearaldahke	bïenjengåaksahvearaldahke	# Compound noun
dataooperatöörigujmie	dataoperatöörigujmie	# Compound noun
basteldihkiegarresvoetemem	bastaldihkiegarresvoetemem	# Deverbal adj + derivated noun compound
lahpemebiernijste	laahpemebiernijste	# Infinite verb + noun
durriemahkeldhgåetijammesistie	durriemahkeldhgåatijammesistie	# Prefix + derivated adj
vïjhtestoerretjuetiegøøktetjuetievïjhteluhkiegööktinie	vïjhtestoerretjuetiegøøktetjuetievïjhteluhkiegööktine	# Number compound
moereprohtokollemistijæjnedh	moereprotokollemistijæjnedh	# Noun + noun + derived noun compound
laahkoemesside	laahkoemasside	# Derivated noun
noeriebinie	nueriebinie	# Adjective comparative
dåeriedimmiejdåajoejen	dåeriedimmiejdåajojen	# Derived adj + derived noun compound
moerensærnieh	moerensaernieh	# Gen noun + noun compound
mïelebarkemasseth	mïelebarkemassedh	# Gen noun + noun compound

