dulmedibie	dul^me^di^bie	# Deverbal verb
nïejtetjasse	nïej^te^tjas^se	# Noun
vuasahtalleles	vua^sah^tal^le^les	# Deverbal adj
AP-beetnegh	AP-bee^tnegh	# Acro + noun compound
AOF-åabpije	AOF-åab^pije	# Acro + Derivated noun compound
mistije-NRK:sne	mis^ti^je-NRK:sne	# Derivated noun + acro compound
St.died-råanjoemijstie	St.died-råan^joemij^stie	# Abbr + derivated noun compound
St.died-samkashierkie	St.died-sam^kas#hier^kie	# Abbr + adj + noun compound
10-gaalvåajja	10-gaalv#åaj^ja	# Digit + noun compound
barkehtalledh	bar^keh^talledh	# Deverbal verb
tjoehpehtalligangan	tjoeh^peh^tal^li^gan#gan	# Deverbal verb + clitc
treemhpesovvimh	treemh^pe^sov^vimh	# Deverbal verb
gervielibie	ger^vie^li^bie	# Deverbal verb
tsoedtsesjidiege	tsoed^tse^sji^die#ge	# Deverbal verb + clitic
doelmestidh	doel^mes^tidh	# Deverbal verb
jaavrijes	jaav^ri^jes	# Denominal adj
laahpelassesne	laah^pe^las^ses^ne	# Deverbal adj
byssegåetiejægan	bys^se^gåe^tie^jæ^gan	# Deverbal verb
gieriehtsadtjese	gie^rieh^tsad^tje^se	# Deverbal noun
bïssemenniejtetjijstie	bïs^se^men#nïej^te^tjij^stie	# Deverbal noun + deverbal noun compound
gieltijesaakesanne	giel^ti^je#saa^ke^san^ne	# Deverbal noun + noun compound
vaeriedimmiesaakenjaevriem	vae^rie^dim^mie#saa^ken#jaev^riem	# Deverbal noun + noun + noun compound
ruevtienbiestememoerevaarjoen	ruev^tien#bies^te^me#moe^re#vaar^joen	# Noun + deverbal noun + noun + noun compound
ovmessietjoelijiprïhtjegigujmie	ov^mes^sie#tjoe^li^ji#prïh^tje^gi^guj^mie	# Adj + denominal noun + noun
Bass-stredet	Bass-stre^det	# Name
Fisklös-gieregijstie	Fisk^lös-gie^re^gijstie	# Name
Fort-de-France-gierhkie	Fort-de-France-gierh^kie	# Name + noun compound
Koskimies-soejkesjimmiereagkaj	Koskimies-soej^ke^sjim^mie#reag^kaj	# Name + noun + noun compound
aeblehtsvoetegærjaaamhtesh	aeb^lehts^voe^te#gær^ja#aamh^tesh	# Noun + noun + noun compound
ledtiejmoeresoejjegimmiengænnah	led^tiej#moe^re#soej^je^gim^mien#gæn^nah	# Noun + noun + deverbal noun + clitic
sijjiesaernienniejtinegan	sij^jie#saer^nien#nïej^ti^ne^gan	# Noun + noun +noun + clitic
gealtelesvoetegih	geal^te^les^voe^te#gih	# Deadjectival noun + clitic
aeblehtsvoetenadth	aeb^lehts^voe^te^nadth	# Noun
Tjellientjåånnide	Tjel^lien^tjåån^ni^de	# Name
Tjellientjåånne-Tjiddiemaajjine	Tjel^lien^tjåån^ne-Tjid^die^maaj^ji^ne	# Name gen + name compound
balvedhlaaketje	bal^vedh^laa^ke^tje	# Adj
jealam	jea^lam	# Verb
bïenjengåaksahvearaldahke	bïen^jen#gåak^sah#vea^ral^dahke	# Compound noun
dataoperatöörigujmie	da^ta#o^pe^ra^tööri^guj^mie	# Compound noun
bastaldihkiegarresvoetemem	bas^tal^dih^kie#gar^res^voe^te^mem	# Deverbal adj + derivated noun compound
laehpemebiernijste	laeh^pe^me#bier^nij^ste	# Infinite verb + noun
bæjngoldsgåatijammesistie	bæj^ngolds#gåa^ti^jam^me^sis^tie	# Prefix + derivated adj
vïjhtestoerretjuetiegøøktetjuetievïjhteluhkiegööktine	vïjh^te#stoer^re#tjue^tie#gøøk^te#tjue^tie#vïjh^te#luh^kie#göök^tine	# Number compound
moereprotokollemistijæjnedh	moe^re#pro^to^kol^le#mis^ti^jæj^nedh	# Noun + noun + derived noun compound
laahkoemasside	laah^koe^mas^si^de	# Derivated noun
nueriebinie	nue^rie^bi^nie	# Adjective comparative
dåeriedimmiejdåajojen	dåe^rie^dim^miej#dåa^jo^jen	# Derived adj + derived noun compound
moerensaernieh	moe^ren#saer^nieh	# Gen noun + noun compound
mïelenbarkemassedh	mïe^len#bar^ke^mas^sedh	# Gen noun + noun compound

