Config:
  Spec: ../pipespec.xml
  Variants: [smagram-dev, smagram]

Tests:

  - "Saemieh akte unnebelåhkoe Nöörjesne jïh dan åvteste	ij bæjjese	jaksh sïejhme demokrateles årgaanine mah jienebelåhkoedemokratijem betnesne utnieh."
  - "Dejtie mah Finnmaarhken ålkoelistie båetieh Saemiedigkie maaksa fealadimmien jïh årromen åvteste 10 almetjidie	gaertjiedamme bæjjese	5000 kråvnide fïerhten almetjen åvteste."
  - "Moenehtse lea råajvarimmiejgujmie båateme mah jienebh siebriedahkesuerkieh feerhmieh , men råajvarimmieh maanide jïh noeride , maanagiertese jïh skuvlese	leah bæjjese	lutnjeme goh joekoen vihkeles bæjjese fulkedh."
  - "Daesnie saemien nyjsenæjjaj byjjes råålle båatsosne akte hijven vuesiehtimmie , jïh maam	sïjhtebe bæjjese	vaeltedh New_Yorkesne , Larsen jeahta."
  - "Tjaelieh bæjjese	gaajhkesh mah sijhtieh meatan årrodh dov redaksjovneste , jïh mujhtieh dovne nommem , e-påasteadressem jïh tellefovnenommerem fïereguhtese tjaeledh."
  - "Dan åvteste learoesoejkesje saemieïn gïelesne mubpiengïeline ,	lea bæjjese	bigkeme guktie dïhte edtja sjiehtedh gaajhkide learoehkidie ovmessie åvtedaajroejgujmie , learoehkide mah ånnetji guhkebe tijjem darpesjieh gïelem lieredh jih learoehkide mah saemien gïeline aelkieh ovmessie jaepiedaltesinie."
  - "Learoesoejkesje faagesne saemien mubpiengïeline	lea bæjjese	bigkeme guktie 9 daltesh åtna."
  - "Saemiedigkien åesie honoraareste lea	gaertjiedamme bæjjese	jeenjemes 15_000 kråvnaj raajan."
  - "30_000 kråvnaj raajan fierhten saemiengïelen maanagïertebarkijasse ellies barkosne ,	gaertjiedamme bæjjese	göökte saemiengïelen barkijidie fïerhtene goevtesisnie."
  - "Dejnie staeries bieliejaepien politihkeles tjåanghkojne	edtja bæjjese	vaeltedh tsiehkiem jïh evtiedimmiedaerpiesvoetide saemien siebriedahkide , aamhtesh vihkeles prinsihpeles karakteereste jïh prosessh mah juhtieminie."
  - "Dåarjoe lea aerviedamme mestie man gellie saemien goevtesh leah maanagïertesne jïh man gellie saemiengïelen barkijh goevtesinie (	gaertjiedamme bæjjese	göökte saemiengïelen barkijidie fïerhtene goevtesisnie )."
  - "Saemiedigkien låhkoe honoraareste maahta jeenjemes 50_% årrodh ,	gaertjiedamme bæjjese	15_000 kråvnaj raajan."
  - "Lissine maahta vuelkemedåarjoem vedtedh ,	gaertjiedamme bæjjese	10_000 kråvnaj raajan."
  - "Saemiedigkien åesie honoraareste lea	gaertjiedamme bæjjese	jeenjemes 15_000 kråvnaj raajan."
  - "Tjåanghkoeåvtehke maahta jeatjah tjirkijidie baakoem vedtedh ikth don aamhtesasse mij	lea bæjjese	vaaltasovveme gyhtjelassesne , aktine håalometïjjine gaertjiedamme akten minudtese."
  - "Raeriestimmieh jïh lahtestimmieh mah leah åvtelhbodti bïeljelamme deellemen tjïrrh stoerretjåanghkoeåvtehkasse Saemiedigkien reeremen baaktoe minngemes ts. 16.00 biejjien åvtelen aamhtese	edtja bæjjese	vaaltasovvedh stoerretjåanghkosne , gïetesuvvieh goh raeriestimmieh jïh lahtestimmieh tsiehkesne a )."
  - "Akte tjirkije mij ij leah stïeresne savkesne gosse tjåanghkoeåvtehke bæjhkohte akte aamhtese	lea bæjjese	vaaltasovveme voteradæmman , ij leah meatan voteradimmesne."
  - "Jeatjah gaavhtan dle bïevnese	ij bæjjese	vaeltieh ulmieh jïh strategijh mah tjïelkelaakan våajnoes båetieh jeatjah bïevnesinie Saemiedigkesne."
  - "Dellie learohkh aktem elliesåbpoe guvviem åadtjoeh guktie dah saemien sijjienommh	leah bæjjese	bigkeme."
  - "Dah leah gyhtjelassh mejtie	maahta bæjjese	vaeltedh aktene dåaresthfaageles aamhtesisnie Saemien 2 jïh eatnemelearosne / siebriedahkefaagesne."
  - "Learohkh maehtieh mobijletellefovnem , mp3-spielerem jallh maam_akt jeatjebem nåhtadidh mejnie	gåarede bæjjese	vaeltedh , jïh baakoeh jïh lahtesh lohkedh mejtie maahta mænngan goltelidh."
  - "Ryöknedimmietjiehpiesvoeth lea maehtedh daajroem nuhtjedh taali jïh veahkaj bïjre strategijigujmie ektine juktie bæjjese bïejeme jïh	ij bæjjese	bïejeme laavenjassh loetedh ( aritmetihkesne )."
  - "barkedh abpe taalesuerkesne 0-20 , jïh ij ajve taalesuerkesne 0_-10 ; daate lea vihkeles juktie guarkedh guktie posisjovnesysteeme	lea bæjjese	bigkeme aktigujmie jïh luhkiejgujmie." 
  - "Ryöknedimmietjiehpiesvoeth lea maehtedh daajroem nuhtjedh taali jïh veahkaj bïjre strategijigujmie ektine juktie bæjjese bïejeme jïh	ij bæjjese	bïejeme laavenjassh loetedh ( aritmetihkesne )"
  - "Ij leah naaken dejstie laavenjassijste buektiehtamme addisjovnine jallh subtraksjovnine , mejtie	lea bæjjese	bïejeme laavenjassh , jallh laavenjassh aktene kontekstesne."
  - "tjoejem bæjjese	vaeltedh digitale viehkiedïrregigujmie"
  - "Juktie daam soejkesjem tjïrrehtidh tjuara daejtie programmide nåhtadidh : iTunes , Media Player , Mp3-spielere , Audacity jïh programmh mejgujmie	tjoejem bæjjese	vaalta."
  - "Ryöknedimmietjiehpiesvoeth lea maehtedh daajroem nuhtjedh taali jïh veahkaj bïjre strategijigujmie ektine juktie bæjjese bïejeme jïh	ij bæjjese	bïejeme laavenjassh loetedh ( aritmetihkesne )."
  - "Dej jeanatjommes båarasommes maanajgujmie dah geerve almetjh	maehtieh bæjjese	vaeltedh dam maam jiïtje vuejnieh , maanajgujmie dan bïjre soptsestidh jïh dejgujmie digkiedidh."
  - "Bööredidie aaj eejhtegidie raeriestimmiejgujmie båetedh teemaj bïjre , mejtie	sijhtieh bæjjese	vaeltedh ektietjåanghkojne."
  - "C. Maam teemide	sïjhtede bæjjese	vaeltedh minngebe eejhtegetjåanghkosne?"
  - "buerkiestidh guktie tjaalegh	leah bæjjese	bigkeme viehkine dïejvesijstie grammatihkeste jïh tjaalegedaajroste , jïh joekehtsi bïjre soptsestidh nöörjen jïh saemien gaskem"
  - "Reakta-åtnosne	eekieh bæjjese	lutnjesovvedh."
  - "kruepieslaakan buerkiestidh guktie almetjen kråahpe	lea bæjjese	bigkeme
  - "buerkiestidh guktie aamhth	leah bæjjese	bigkeme , jïh guktie aamhth maehtieh jorkesidh viehkine dïejvesidie atovmh jïh molekylh nuhtjedh
  - "buerkiestidh guktie kreeke- jïh sjædtoecellah	leah bæjjese	bigkeme , jïh åejvievæhtide buerkiestidh fotosyntesesne jïh celle-voejngehtimmesne
  - "Tjaeleldh govlesadteme evtiesåvva gosse leara guktie gïele	lea bæjjese	bigkeme jïh struktuvren bïjre , jïh gosse ovmessie sjangerigujmie barka mah stuerebe stuerebe krïevenassh utnieh ektiedimmieh guarkedh tjaalegi hammoen jïh funksjovnen gaskem."
  - "dam vihkielommes raajeseanalysem darjodh juktie subjektem , verbalem jïh objektem raajesisnie gaavnedh , jïh vuesiehtidh viehkine dïejvesijstie grammatihkeste jïh tjaalegedaajroste , guktie tjaalegh	leah bæjjese	bigkesovveme
  - "grammatihkeles dïejvesh haalvedh mah buerkiestieh guktie gïele	lea bæjjese	bigkeme
  - "Åejviesuerkie lea guktie siebriedahkefaageles	goerkesem bæjjese	bigkie tjetskehkevoeten , onterdimmien jïh sjugneden darjomi tjïrrh."
  - "buerkiestidh guktie dah möölegh gåhkose , arealeste jïh volumese	leah bæjjese	bigkeme , jïh bïjrem , arealem , bijjieskieriem jïh volumem aerviedidh guektien-jïh golmendimensjovnaale figuvrijste
  - "Giehtjedimmie demokratijereformeste edtja våaromem vedtedh Stoerredægkan raeriestimmiejgujmie vijriesåbpoe barkedh jarkelimmiej bïjre Maadthlaakesne , mah	leah bæjjese	vaalteme gærhkoeliktesen mietie."
  - "Trööndelagesne : ” Vierhtieh juktie nasjovnale aarvoeh gorredidh soejkesje- jïh bigkemeaamhtesinie urrebe tïjjen kultuvremojhtesereeremen sisnjelen ,	sæjhta bæjjese	vaeltedh ekonomijesoejkesjeboelhken jaepiej 2012-2015."
  - "Jaepiej 2012-13 budsjedterede tjåanghkan 92,9 mill. kråvnah nåhtadidh gïehteldimmiebudsjedtesne baalhkijste momskompensasjovneste skåårvemijstie , mestie 61,9 mill. kråvnah foenteste båetieh mij	leah bæjjese	bigkeme aarebi jaepiej."
  - "Ööhpehtimmiesektovri mierieh	leah bæjjese	staeriedamme 4,4 mill. kråvnajgujmie pensjovnemaaksojde , jïh 0,6 mill. kråvnah læssanamme barkoevedtijemaaksose , viertiestamme daltesinie ekonomijesoejkesjisnie 2011-14. 3.5 Baalhkah – jïh åasabijjiedimmie
  - "2013 lea dïhte minngemes jaepie mijjieh maehtebe vierhtieh öörnegistie nåhtadidh gïehteldimmiebudsjedtesne , jïh daan jaepien sïjhtebe amma 48 mill. kråvnah gïehteldimmesne nåhtadidh , gosse abpe foentem låeptebe mij	lea bæjjese	bigkeme aarebi jaepiej."
  - "Dåarjoe museumdeponijese	lea bæjjese	staeriedamme guktie daaletje latjkoe lea."
  - "Namhtah baeniebåehtjierdimmie dejstie noerijste mah leah 19-20 jaepien båeries	lea bæjjese	lutnjeme goh akte prijoriteradamme råajvarimmie 2011 raejeste 0,8 mill. kråvnajgujmie."
  - "Øøhpehtimmiesuerkiej mierieh	leah bæjjese	staeriedamme 11,3 mill. kråvnajgujmie pensjovnemaaksose , jïh 1,7 mill. kråvnah læssanamme barkoevedtijemaaksose viertiestamme dejnie daltesinie ekonomijesoejkesjisnie 2010-13. 3.5 Baalhka-jïh åasabijjiedimmie Baalhka- jïh åasabijjiedimmie budsjedtesne 2011 jïh ekonomijesoejkesjisnie 2011-14 våaromem åtna baalhka- jïh åasabijjiedimmesned dennie raeriestimmesne staatebudsjedtese."
Lissine budsjedterede 6,1 mill. kråvnah nåhtadidh disposisjovnefoenteste boelhken , mij	lea bæjjese	bigkeme vierhtijste momskompensasjovneøørnegistie , v. ållermaehteminie stuhtjesne 5.2. 5.5 Reentebaalhkah jïh dïenes te NTE Holding as ’ ste
Dam	edtja bæjjese	vaeltedh aktene tjåanghkosne dej åarjel-saemien fylhkigujmie jïh saemiedigkine daan tjaktjen , Annikken Kjær Haraldsen jeahta."
Veeljemelæstoeh	leah bæjjese	bïejeme våaroehtamme öörnegen mietie."
Religion textsstøtter ikke utvidet kontekst
Aavrehke dah gïeh vieksiesvoetem datneste åadtjoeh , dah gïeh	erhtieh bæjjese	teempelasse vuelkedh."
» Gosse Jupmele galhkeme Abrahamine soptsestidh , dellie Abrahamen luvhtie	vöölki bæjjese	alman."
Gellie åålmegh gelkieh vuelkedh jïh jiehtedh : « Båetede ,	vaedtsebe bæjjese	Jaahken Jupmelen gåatan guktie jïjtse geajnojde åehpiedehtedh , altese baalkide galkebe vaedtsedh."
Vuartasjidie bæjjese	alnadahkese : Gie gaajhkem sjugniedamme ?
Biejjieh båateme gosse Jeesuse	edtji bæjjese	alman vuelkedh , Jerusalemen vööste jarkeli juktie dahkoe sïjhti vuelkedh."
Gosse Jeesuse dam jeahteme , dellie	vaadtsaji bæjjese	Jerusalemese."
Dellie dah gïeh Judejesne årroeminie ,	tjuerieh bæjjese	vaeride rïpmedh."
Dah jeehtigan : « Galilejan almetjh , mannasinie	vuartasjidie bæjjese	alman ?
Mïnnede bæjjese	hïejese."
Dellie vihth dejtie luhkiegööktesidie meatan vaalta jïh dejtie såårne guktie sutnjien sjædta : « Mijjieh govlh	galkebe bæjjese	Jerusalemese , jïh Almetjebaernie galka åvtehkehearride jïh tjaaleh-åahpetjidie vadtasovvedh."
Biejjie båata gosse vaeptieh Efraimen vaereste gelkieh tjåarvodh : « Båetede ,	vaedtsebe bæjjese	Sionese , Håatjede jïh aavoedidie Jaahkine , tjåarvode åajvemes åålmegen gaavhtan !
Gellie åålmegh gelkieh vuelkedh jïh jiehtedh : « Båetede ,	vaedtsebe bæjjese	Jaahken Jupmelen gåatan guktie jïjtse geajnojde vuesiehtidh guktie galkebe jïjtse baalkide vaedtsedh."
Eah dah elmesne guktie tjoevrh jiehtedh : « Gie	sæjhta bæjjese	alman mijjen åvteste vuelkedh jïh dejtie veedtjedh guktie maehtebe dejtie govledh jïh dej mietie jieledh ?
Mose Moaben guevtielijstie vöölki jïh	veedtsi bæjjese	Pisga-vaaran , Nebo-tjahkese , mij Jerikon jåårke."
Eah almetjh	åadtjoeh bæjjese	Mosine båetedh."
" 5 Jupmele satnem olkese vaedtsehte jïh jeahta : ”	Vuejnieh bæjjese	alman jïh ryöknh dejtie naestide , jis maahtah !
1 Jupmele Mosese jeehti : "	Vaarrh bæjjese	Åajvan , datne jïh Arone , Nadave jïh Avihu jïh tjijhtjeluhkie Jisrajelen voeresijstie."
Jïh almetjh eah	åadtjoeh bæjjese	Mosine båetedh."
åålmegisnie mij bissie biejjide	dahkoe bæjjese	mïnnin."
2 Govhte biejjieh dan mænngan Jeesuse Pïehterem jïh Jaahkem jïh Jåhham meatan	vaalta bæjjese	stoere vaaran oktegh tjietjelen årrodh."
Dellie aaj vihth dejtie luhkie gööktesidie meatan vaalta jïh dejtie såårne mij edtja sutnjien deahpadidh : 33 " Mijjieh govlh	edtjibie bæjjese	Jerusalemese , jïh Almetjen Baernie galka åejviehearride jïh tjaalege-ååhpetjidie vadtasovvedh."
11 Dah jeehtigan : " Galile ´ an almetjh , mannasinie tjåadtjoen	vuartesjeminie bæjjese	alman ?
6 Badth rïektesvoete jaahkoen tjïrrh jeahta : Aellieh dov vaajmosne ussjedh : Gie	edtja bæjjese	Alman vuelkedh - Kristusem diekie våålese veedtjedh -_7 jallh : Gie edtja våålese jaemierïjhkese vuelkedh - Kristusem bæjjese veedtjedh."
Non-fiction textsstøtter ikke utvidet kontekst
Stuhtje voestes	aejkien bæjjese	bïejesovvi Sapporosne , Japanisnie jaepien 1995
Daelie , luhkiegöökte jaepieh dan mænngan , vuasahtalleme	sæjhta bæjjese	bïejesovvedh dan ellen voestes aejkien
Dellie dah lin joe dam johke-låemiem hïnneme vaesedh jïh mubpiem bieliem	båetieh bæjjese	.
Edtjieh bæjjese	, dellie speanjoe dagkoe åvtelisnie , dellie dan nualan tjöödtjestieh."
Nåå , dïhte jårra , åejjie	lij bæjjese	, dellie jårra våålese , mov vuestelen."
Onnetji lij lïjhke gællasjasteme , dle	tjuedtjieli bæjjese	.
Die Laasse jeahta munnjien , satne edtja	vaarredh bæjjese	dahkoe."
Die easkah Laasse fehkehte jïh vuajnije , jïh die båata bååstede munnjien sarhkele edtja satne	vaarredh bæjjese	: « Tjåadtjoeh datne aehtjie bijjene daesnie."
Dah barre	vuelkieh bæjjese	dan beetsetjasse jïh die gåatoeh desnie."
Gosse edtjimen die tjoejkijidh , die dïhte råantjoe tjuedtjele jïh	gahpeste bæjjese	, jïh die vualka vuhtsen våålese dam njoejem."
Nåå gie edtja die dïhte	tjoejkedh bæjjese	dan gaertienasse jïh dam laedtiem birredh edtja steegkedh dam daammem dan jïjjese."
Dïhte saemie onterdi , juktie idtji satne lovveh , goh	böötigan bæjjese	dan gaaltijen mietie."
" " Ibie maa mijjieh maehtieh , " bovtsh svååroeh , " biejjie guaka , bïjvele sjædta , ibie maa mijjieh , " Guktie dah feerin	tsuvvien bæjjese	don tjahkese."
Datne edtjh åadtjodh åeredh goske biejjie baahkede , dell ' edtjh	tjuedtjielidh bæjjese	jïh vuartasjidh maam dle vuajnah."
Jïh dellie laedtie jeahta dan aereden jïh	gååske bæjjese	edtja vaedtsedh vuartasjidh dam sov laessiem."
Tjïelkesth maam aamhtesidie datne	sïjhth bæjjese	vaeltedh."
Rïhkedahkesne viht	tjöönghkebe bæjjese	Rööpsesvaaran."
Jïh ij tjoerh amma åajaldidh guktie filme	lea bæjjese	bigkeme dejnie gieltegs ovvaantojne , man åvteste filme varke jåhta jïh dutnjien dovne leevles domtesh jïh goerkesem vadta man åvteste stujmiedæjjah gæmhpoem veeltin."
Dle stillie dïhte gaampel gåmma dam nïejtem : "	Gåajvoeh bæjjese	krovhteste daejtie gaampel gaamegidie : edtjien byöpmedalledh."
Leessh bæjjese	gaajhkh filmh jallh nedte-sæjroeh datne edtjh vuesiehtidh."
Jallh maehtebe jiehtedh argumeenth tjuerieh vihkelesvoetem utnedh dan gyhtjelassese maam	tjaelije bæjjese	vaalta :
Jïh goh dellie	vuartasjieh bæjjese	, dellie vuejnieh ahte dïhte elmie goh rïhpese."
Voestegh dle	tjoejkin bæjjese	aktem praare tjaavtesem jïh akten dalvesasse , jïh destie gujht dle dubpelen dohkoe."
–	Vaedtsieh bæjjese	!
– Maam_akt jaksedh mij lea bij emes hællosne – Tjoevkesem båaltajidh gosse	ih bæjjese	jaksh – Båaloem jaksedh mij leah skåapen nualan jårreme , jïh maana ij dam gïetigujmie jaksh."

Ååre-dæjja lea aalvere jih altese tjelmieh vååjnoeh goh gøøkte tjeehpes sievh goh	guavla bæjjese	.
Gierkieh njalhkedihks jih gellien aejkien viht saalhtan 9495gahtja gosse	voejhkele bæjjese	tjaffedh."
–	Vitnedh bæjjese	jih gietem munnjien geelkh."
Aigine	lea bæjjese	goegkerhtamme jih åelkies gietine litnjesne steereminie."
23a Mij taalide	edtjieh bæjjese	lïhkemes låhkagasse mil edh ?
Ceellah leah bigkemeklåbpoeh mejsti e kråahpe	lea bæjjese	bigkeme."
Åedtjieceellah lea doh onn’ohtje biehkieh mejsti e mijjen åedtjieh	leah bæjjese	bigkeme."
Daamtajommes ajve baektjede dan åvteste sovhti ne , men muvhten aejkien maahta bakterijh årrodh mah	leah bæjjese	båateme dan onne kanaalese , gorhken bijjiebielien jïh gaskebieljien gaskesne jïh desnie steegke sovveme."
Dihte saemie onterdi , juktie idtji satne lovveh , goh	böötigan bæjjese	dan gaaltijen mietie."
Tjaelieh bæjjese	gaajhkh krirrieh mah neebnesuvvieh , jïh man daamtaj dah neebnesuvvieh."
Vueliej nille båetedh –	darhkan bæjjese	vuelesne tjaevtedh , gosse aavosne , jïh sæjhta maam vuj guhte joem heevehtidh."
Fiction textsstøtter ikke utvidet kontekst
Goh ij daate kristendomme	båateme bæjjese	dejtie vaeride."
Åadtjoeh maa jïjtje ussjedidh guktie	edtjh bæjjese	båetedh , riepie gæljoeji."
Minngemes dellie	voejhkeli bæjjese	dam moeren-lïedtjem goetsedh."
[ 10 ] Baktuse guhkiem klaasen lihke tjåadtjoeji jih	vuartesji bæjjese	don veelkes skaavhte-baanan."
« Månnoeh	maehtien bæjjese	njaalman njulhtjedh jih altese baenieh beenghkedh , » Baktuse gæljoeji."
« Manne edtjem datnem nehkiehtidh die maahtah	goetsedh bæjjese	vuejnedh !
» « Vielle , nehkehth mannem , die åadtjoem	goetsedh bæjjese	vuejnedh , » Baktuse jeehti."
Manne lim	roehteme bæjjese	gåatan , dan duakan , juktie vuejije edtji vienhtedh manne lim tjoevtenjem ohtsedeminie."
Idtjin hov dellie goh manne reakasim dellie hov	juhtin bæjjese	våålese jih Nöörjese jaa aaj debpede bååstide dle goh låavthgåetide utnin."
Guktie sih dagkerh almetjh sjisjnjielisnie vååjnoeh guhth nimhtie , eah enne misse gænnah	buektehth bæjjese	vuartasjidh jih earoehtidh."
Gaskebiejjien mænngan dle	bussh bæjjese	Aagli gåajkoe , Baektietjåltan / Bergkollese juhtieh."
Guktie sih dagkerh almetjh sjisjnjielisnie vååjnoeh guhth nimhtie , eah enne misse gænnah	buektehth bæjjese	vuartasjidh jih earoehtidh."
Jiehtieh dovne almetjidie gieh våhkoegietjien	edtjieh bæjjese	vaeriebaahkojde , tjoejkedidh , edtjieh soejmi jih tjeahpetjelaakan minnedh guktie eah bovtside sturrh."
− Åå , dïhte gaskelommes buehkie dïhte , mij	edtja bæjjese	njiskiehtidh , buehkie vaestiedi."
Men daelie staaloe dan spaajhte feeri guktie idtji	buektehth bæjjese	tjihkedidh vielie."
− Ajve dïhte unnemes buehkie mij	edtja bæjjese	njiskiehtidh , dïhte unnemes buehkie praahki."
Numhtie dle gåmmebe vöölki	haeleden bæjjese	, guhkebe , guhkebe jïh laavloeji : « Bæjjese bierede , bæjjese bierede !
Jïh dle öövtemes daan_biejjien , » gåmma jeahta jïh	klyjvie bæjjese	dan seangkoen nille , gilledi jïh tjiektjije juelkiej gujmie dohkh_diekie."
− Åå , dïhte gaskelommes buehkie dïhte , mij	edtja bæjjese	njiskiehtidh , buehkie vaestiedi."
Men daelie staaloe dan spaajhte feeri guktie idtji	buektehth bæjjese	tjihkedidh vielie."
− Åå , dïhte gaskelommes buehkie dïhte , mij	edtja bæjjese	njiskiehtidh , buehkie vaestiedi."
Men daelie staaloe dan spaajhte feeri guktie idtji	buektehth bæjjese	tjihkedidh vielie."
− Ajve dïhte unnemes buehkie mij	edtja bæjjese	njiskiehtidh , dïhte unnemes buehkie praahki."
− Ajve dïhte unnemes buehkie mij	edtja bæjjese	njiskiehtidh , dïhte unnemes buehkie praahki."
Newspaper textsstøtter ikke utvidet kontekst
Maanagïertebarkije Lisa Gælok dennie åarjelsaemien maanagïertesne soptseste gaajhkh maanah jïjtje	veedtsin bæjjese	Bergsåsen gåajkoe."
– Dah haarjanimmieh leah vihkeles ihke edtja girtine ektine sjïdtedh dejnie vaahrege boelhkine haeliehtimmeste , gidtjh soejedimmie jïh gosse	edtja bæjjese	alman , Zahl jeahta."
Tjöölleplaave klovretjaetsie	gåavoem bæjjese	alman seedtie."
Dah dan eadtjohke sjidtieh jïh jallan buektehth astasligke tjahkasjidh , dah	tjuerieh bæjjese	jïh naestide tjuvtjiedidh jïh naestieguvvide vuartasjidh."
Dï hte akte aavoesaernie gaajhkesidie mah leah	klumhpiehtamme bæjjese	doh leevles deavah aarebi jaepiej."
Haarjanimmie mij lij gålkoen 25. b. ,	lij bæjjese	bigkeme goh akte spïelehaarjanimmie jïh lij ussjedamme goh akte haarjanimmie tjïelten tellefovnejarngese jïh vaahrastuvremasse."
Preessekonferanse : Haarjanimmie mij lij gålkoen 25. b.	lij bæjjese	bigkeme goh akte spïelehaarjanimmie , jïh lij ussjedamme goh akte haarjanimmie tjïelten tellefovnejarngese jïh vaahrastuvremasse."
Naemhtie guktie tjaetsievierhkie	lea bæjjese	bigkeme daan_biejjien dle tjaetsie Snåasenjaevreste pumpadamme sjædta akten bassengese Finsåsesne jïh desnie guhkiebasse gïetesåvva."
Traahpine jïh vïedtjine gusnie jårrehth jïh	vïedtji bæjjese	vaarrh jnv )."
Manne jueriedisnie man tjaaleldh eksamenasse manne	sïjhtem bæjjese	båetedh , men njaalmeldh sïjhtem bæjjese båetedh siebriedahkefaagese."
Manne jueriedisnie man tjaaleldh eksamenasse manne sïjhtem bæjjese båetedh , men njaalmeldh	sïjhtem bæjjese	båetedh siebriedahkefaagese."
Men eah gaajhkesh vaallah fysihkem , kondisjovnem jallh lastoem	utnieh bæjjese	akten tjahkese tjabredh."
Leevles lij , leevlemes galhkuvisnie dan åvteste manne	tjoerim bæjjese	aktem deavam vaarredh , Ingrid Aasum Jørstad soptseste."
Gosse ånnetji guvvine barkeme , dle dam ovgaervies guvviem meatan	vaalta bæjjese	stuvvan gåajkoe , tjoevkesem dïsse beaja jïh Edith ’ se vuesehte."
Goetsedieh : Rut Iren Granamo jïh Fredrik Guin Lunde	sijhtieh bæjjese	jïh åvtese veartenasse båetedh."
Ajve akte åenehks	mïnneme bæjjese	Vinjen gåajkoe , akte gaajh sjïehteles gåhkoe."
Steinmo soptsesti skïemtjegåetiej maaksoeh guektiengierth sjidtieh fïerhten govhteden jaepien , jïh daate	ij bæjjese	jïh åvtese juhtieh."
Tjaebpies vuasahtalleme jïh stoerre sijjie darjoeh guktie doekeme	lea bæjjese	jåhteme."
– Manne lim	sïjhteme bæjjese	vaaran vuelkedh."
Gosse	veedtsin bæjjese	Aantesvaaran gaajhkesh dan åehpies klåhkoegierkien lïhke tjöödtjestin , akte gierkie mij aktem sjïere tjoejem dorje gosse disse tsaapma."
Manne tjoerim olkese kråapodh klaasen tjï rrh , aaj desnie lopme	lij bæjjese	klaasen gåajkoe , Dunfjell soptseste."
Science textsstøtter ikke utvidet kontekst
Daate daamtaj smaave , eah dan dovres produksjovnh teknihkeles , dan åvteste dah edtjieh vitnedimmiesavkine tjaakanidh bïjre_jarkan laantesne , stoerre jïh smaave sijjine , mejtie	edtja bæjjese	bïejedh jïh rïjvedh dagke 2 aejkieh fïerhten biejjien gosse skuvleste skuvlese mïnneminie."
Vaarjelimmie jïh guhkiebasse evtiedimmie saemien kultuvreaerpeste	tjuara bæjjese	lokngesovvedh akten nasjonaale jïh gaskenasjonaale reeremedaltesasse  mijjieh akte åålmege njieljie laantine , Russlaante , Såevmie , Sveerje jïh Nöörje  gaajhkine njieljie laantine saemien kultuvre lea staaten bieleste , kolonialiseradimmiem , eadtjohke nåhkehtimmiem , eadtjohke assimileradimmem jïh eadtjohke dïedtelgimmiem dååjreme."
Krievvien juhtememöönstere	lea bæjjese	vaaran giesege jïh vuelielaantese daelvege , daate sæjhta jiehtedh mearan juhtemegeajnoe lea noerhte-åarjel Finnmaarhkesne , juhtemegeajnoe lea luvlie-jillie åarjeldajvesne."
« ‹ 12 › »  goto_page   of 2
