I denne filen er det ord som er definert som po og/eller pr i smanob-dict, men de gir ikke tilsvarende analyse i sma.fst.

- De som er riktige, legg dem til i fst som po/pr.
- Noen kan være feilstavet, eller at de er Adv eller noe annet. Skriv kommentarer til ordene, slik at vi får retta dem i dict.


aalkoelisnie	aalkoelisnie	+?	po
aalkoelistie	aalkoelistie	+?	po
aatsoli	aatsoli	+?	po
aatsoli	aatsoli	+?	pr
aerebe	aeredh+V+Imprt+Pl1	po       right form: aarebi
aerebe	aeredh+V+Ind+Prs+Pl1	po       right form: aarebi
alkalisnie	alkalisnie+Adv	po
alkalistie	alkalistie+Adv	po
avtelen	avtelen+Adv	po
avtelen	avtelen+Adv	pr
avteli	avteli	+?	po
avteli	avteli	+?	pr
avtelisnie	avtelisnie	+?	po
avtelistie	avtelistie	+?	po
avtem	avtem+Adv	po
avtene	avtene+Adv	po
baaltelen	baaltelen	+?	po
baaltelen	baaltelen	+?	pr
baalteli	baalteli	+?	po
baalteli	baalteli	+?	pr
baaltelisnie	baaltelisnie	+?	po
baaltelistie	baaltelistie	+?	po
bealan	beala+N+Sg+Gen	po
bealan	bielie+N+Sg+Ill+Uml	po
bielelen	bielelen+Po	pr
bieleli	bieleli	+?	po
bielelisnie	bielelisnie	+?	po    right form: bielielisnie
bielelistie	bielelistie	+?	po     right form: bielielistie
bielesne	bielie+N+Sg+Ine	po
bieleste	bielie+N+Sg+Ela	po
bijjelen	bijjelen+Adv	pr
bijjelen	bijjelen+Po	pr
bijjeli	bijjeli	+?	po
bijjelisnie	bijjelisnie	+?	po     right form:bijjielisnie
bijjielistie	bijjielistie+Po	po      right form:bijjielisnie
boehten	boehten	+?	po
bååktjesne	bååktjesne	+?	po
bååktjeste	baaktjedh+V+Der/PassS+Uml+Der1+Der/stidh+V+Ind+Prs+Sg3	po
bæjngolde	bæjngolde+Adv	po
bæjngolen	bæjngolen+Adv	po
bæjngolen	bæjngolen+Adv	pr
bæjngoli	bæjngoli	+?	po
daebpelen	daebpelen+Adv	po
daebpelen	daebpelen+Adv	pr
daebpeli	daebpeli	+?	po
daebpeli	daebpeli	+?	pr
daebpielisnie	daebpielisnie+Adv	po
daebpielistie	daebpielistie	+?	po
debpeli	debpeli	+?	po
debpielisnie	debpielisnie	+?	po
debpielistie	debpielistie	+?	po
dierh	dïeredh+V+ConNeg	po        right form: dïehre, dïere, dïereh, *dïete
dierh	dïeredh+V+Imprt+Sg2	po        right form: dïehre, dïere, dïereh, *dïete
dierh	dïeredh+V+Ind+Prs+Sg2	po        right form: dïehre, dïere, dïereh, *dïete
dubpelen	dubpelen	+?	po
dubpelen	dubpelen	+?	pr
dubpeli	dubpeli	+?	po
dubpeli	dubpeli	+?	pr
dubpielistie	dubpielistie	+?	po
duebpelen	duebpelen	+?	po
duebpeli	duebpeli	+?	po
duebpielisnie	duebpielisnie	+?	po
duebpielistie	duebpielistie	+?	po
duekelen	duekelen	+?	po
dïereh	dïereh	+?	po
ektelen	ektelen+Adv	po              only adverb
ekteli	ekteli	+?	po              only adverb
ektielisnie	ektielisnie	+?	po              only adverb
ektielistie	ektielistie	+?	po              only adverb
gaavnefedtie	gaavnefedtie	+?	po
gaavnuhte	gaavnuhte	+?	po
gaskese	gaske+N+Sg+Ill	po
gaskese	gaske+N+Sg+Nom+PxSg3	po
gaskese	gaskese+N+Sg+Nom	po
genhtsemen	genhtseme+N+Sg+Gen	po
genhtsemi	genhtseme+N+Pl+Gen	po
genhtsiemisnie	genhtseme+N+Sg+Ine	po
genhtsiemistie	genhtseme+N+Sg+Ela	po
goerese	goere+N+Sg+Ill	po
goerese	goere+N+Sg+Nom+PxSg3	po
guektelen	guektelen	+?	po 
guektelisnie	guektelisnie	+?	po       right form:  guektielisnie  
guektielistie	guektielistie	+?	po 
gåajka	gåajka	+?	po
jillelen	jillelen	+?	po
jilleli	jilleli	+?	po
jillielisnie	jillielisnie+Adv	po
jillielistie	jillielistie+Adv	po
juassah	juassah	+?	po
luvleli	luvleli+Adv	po
luvleli	luvleli+Adv	pr
luvlielistie	luvlielistie	+?	po
maadtegasse	maadtege+N+Sg+Ill	po
meatesth	meatesth	+?	po
miehtjelde	miehtjelde+Adv	po
miehtjelen	miehtjelen	+?	po
miehtjelen	miehtjelen	+?	pr
miehtjeli	miehtjeli	+?	po
miehtjelisnie	miehtjelisnie	+?	po       right form:  miehtjielisnie 
miehtjielasse	miehtjielasse	+?	po
miehtjielistie	miehtjielistie+Adv	po
mietelen	mietedh+V+Der1+Der/lidh+V+VGen	po
mietelen	mïetedh+V+Der1+Der/lidh+V+VGen	po
mietelen	mïetele+N+Sg+Gen	po
mieteli	mietedh+V+Der1+Der/lidh+V+Ind+Prt+Sg3	po
mieteli	mïetedh+V+Der1+Der/lidh+V+Ind+Prt+Sg3	po
mieteli	mïetedh+V+Der1+Der/lidh+V+Ind+Prt+Sg3	po
mieteli	mïetele+N+Pl+Gen	po
mietielisnie	mietielisnie	+?	po
mihte	mihte	+?	po
mihti	mihti	+?	po
minngelde	minngelde+Adv	po
minngelen	minngelen	+?	po
minngeli	minngeli	+?	po
minngielisnie	minngielisnie	+?	po
minngielistie	minngielistie	+?	po
nallatjasse	nallatjasse	+?	po
namtegh	namtegh	+?	po				right form: namhtegh
njeajah	njeajah	+?	po
njoektjelen	njoektjelen+Adv	pr
noerhtelen	noerhtelen+Adv	po
noerhtelen	noerhtelen+Adv	pr
noerhteli	noerhteli+Adv	po
noerhteli	noerhteli+Adv	pr
noerhtielisnie	noerhtielisnie	+?	po				right form: noerhtelisnie
noerhtielistie	noerhtielistie	+?	po				right form: noerhtelistie
sakte	sakte	+?	po
sisnjeli	sisnjele+N+Pl+Gen	po
sisnjielistie	sisnjielistie	+?	po
sjisjnjeli	sjisjnjele+N+Pl+Gen	po
syjretjisnie	sæjroe+N+Der1+Der/Dim+N+Sg+Ine	po
sæsngatjisnie	sæsngatjisnie	+?	po
vuelelen	vuelelen+Adv	po
vuelelen	vuelelen+Adv	pr
vueleli	vueleli	+?	po
vuelielisnie	vuelielisnie	+?	po
vuestelen	vuestelen	+?	po
vuesteli	vuesteli	+?	po
vuestielisnie	vuestielisnie	+?	po
vuestielistie	vuestielistie	+?	po
åarjalisnie	åarjalisnie	+?	po
åarjalistie	åarjalistie	+?	po
åarjelen	åarjelen+Adv	po
åarjeli	åarjeli	+?	po
åarjielistie	åarjielistie	+?	po
åebrelen	åebrelen+Adv	po				only adverb
åebreli	åebreli	+?	po				only adverb
åebrielisnie	åebrielisnie	+?	po				only adverb
åebrielistie	åebrielistie	+?	po				only adverb
åerjielisnie	åerjielisnie	+?	po
ålkoelistie	ålkoelistie+Adv	po
ålkolen	ålkolen+Adv	po
ålkoli	ålkoli	+?	po
åvtelen	åvtelen+Po	pr
åvtene	åvtanidh+V+Ind+Prs+Sg3	po
åvtene	åvtene+Adv	po
åvtene	åvtenidh+V+Ind+Prs+Sg3	po
åvtine	åvtine+Adv	po
