Oppsummering:
sjekk ut med informanter om 'istedh' og 'estedh' -endelsen. trekk ut en 20-tallsord. 

'distedh' er et '2.ledd avledning' fra trestavelseseverb. 


baerhkieldistedh= baerhkieldidh
?   bitnehtistedh(subtiv) = bitnehtidh(kausativ>) = semantisk like iflg. ordboka = hva er da normen?
byöpmedistedh = byöpmedidh
?  bïeselistedh= semantisk like; bïeselidh(sub,frek), bïeselistedh- bïesedh iflg.ordboka=hva er da normen?
bïhkehtjistedh -> bïhkehtjidh -> bïhkedh
dabtehtistedh = dabtehtidh/damtehtidh 
dassedistedh -> dassedidh(frek) -> dassedh (miste litt nå og da; plutselig miste flere) 
dibrehtistedh = dibrehtidh
dåajvoehtistedh = dåajvoehtidh
fïeskesjistedh -> fïeskesjidh(smusse til) -> 'fïeskesjistedh'= gnu og rengjøre'
fïjnehtistedh = fïjnehtidh
gaatskehtjistedh -> gaatskehtjidh
gadtsehtistedh-> gadtsehtidh- mate barn med skje
gajhkedistedh -> gajhkedidh
gaptjedistedh-> gaptjedidh-> dekke til, 'bre over som snarest'
gejhkielistedh -> gejhkielidh = rive istykker
guhkiedistedh = guhkiedidh
gåvverdistedh - gåvverdidh 
gåårvehtistedh = gåårvehtidh 
?   ierngiehtistedh, iernjiehtestielidh=  Hva er norm?- > iernjiehtidh og  ierngiehtidh

joksedistedh -> joksedidh, *jokseridh
jåvkedistedh  = jåvkedidh->jåvkedh 'fyke igjen om flere spor'
jåvkelistedh = fyke igjen om et spor
lijrehtistedh -> lijrehtidh
maatadistedh -> 	maatadidh 'spise' =   3.st.verb = lånord?
måjhtadistedh = mujhtedh, måjhtajidh -> 'huske på i en fart, 
                 komme på som snarest' - måjhtadidh?? 
njåatjoedistedh = 'skynde se å melke'
nïhtehtjistedh 
ristedh
rïrresjistedh - rïrresjidh 
saajenistedh -> saajenidh	
skrovhpesjistedh -> skrovhpesjidh -> skrovhpes 
?   suvriedistedh = suvriedidh, suvriedistedh I	være sur, i dårlig humør: hva er norm? 
?   tjaabroehtistedh = tjaabrodh ? - tjaabroehtidh?  

tjoehpedistedh = tjoehpedh -> tjoehpedidh -> tjoehpedistedh = 2 ledd
tjåenghkierdistedh
tjöönghkedistedh = tjöönghkedh -> tjöönghkedidh -> tjöönghkedistedh = 2 ledd
tsaapedistedh = tsaapedh-> tsaapestidh - tsaapedidh-> tsaapedistedh = 2 ledd 
ussjedistedh = ussjedidh
vueliedistedh = 
åarajistedh = plutselig sovne; plutselig legge seg ned for å dø
åådtjedistedh = kaste, fange inn flere rein i en fart = åådtjedidh 
